111111111111111
1E1000000000001
1000000P0C00001
1000011C1110001
100000000000001
100000000000001
100000000000001
111111111111111
