1111111111111111111111111111111111111111111
1P00000000000000100000001000000000000000001
1000000111111000100000001000111110000000001
100100010000100010N000001000100010000001001
1000000100000000100000001000000010000000001
100C000111111111100000001111111110000000001
1000000000000000000000000000000000000000001
1111100000000000000000000000000000000011111
1000000000000000N000E00N0000000000000000001
1000000111111100000000000001111110000000001
1000000100000100000000000001000010000000001
1000000100000000000C00000000000010000000001
1000000111111111100000001111111110000000001
1000N000000000000000000000000000000000N0001
1000000000000000000000000000000000000000001
1000CC000000000000000000000000C000000000001
1000100100000000000000000000000010000010001
1000000011111111111111111111111100000000001
1000CC0000000000000000000000000000000000001
1000000000000000000000000000000000000000001
1111111111111111111111111111111111111111111