11111111111111111111111111111111111
10000C1C0000CC111100C001001111100C1
101111101111111000000N111000C000011
10010100000010001110001111101110011
1101P00000000C0100111001000C0000001
1000000001C000000111110010001111111
100110110011101NNNNN100010000100011
1N0011100000001CC0001000C00000010C1
1C0001C0100000100C10001110000111111
11110111101110000111100000000001111
10000N000011000000000C000N001100011
10111011101101111111011110111111011
10E000001111000C1111C111100001C0011
11111111111111111111111111111111111