111111111111111111111111111111111111111111111111
1E0C0000C0000C1111111111111111111111111111111111
100000C0000P001111111111111111111111111111111111
100001111110001111111111111111111111111111111111
1000000C0000001111111111111111111111111111111111
1000C0000C000C1111111111111111111111111111111111
100000000000001111111111111111111111111111111111
111111111111111111111111111111111111111111111111
111111111111111111111111111111111111111111111111