11111111111111111111111111111111111
10000000000000100C00100000000000001
10000011111100000000000111110C00001
101000100C01001000001001CN010001001
10000010000000100000100000010000001
10000011111011100000111011110000001
10000000000000000000000000000000001
11110000000000000N00000000000011111
100000000P0000000E00000000000000001
10000011111110000000001111110000001
1000001000N010000000001N00010000001
10000000000000000000000000000000001
11111111111111111111111111111111111
